NO ./images/north.xpm
SO ./images/west.xpm
WE ./images/south.xpm
EA ./images/east.xpm

F 205,150,102
C 200,200,200

1111111111111111111111111
1000000000110000000000001
1011000001110000000000001
1001000000000000000000001111111
11111111101100000111000000000001
100000000011000001110111111111111
1111011111111101110000010000
11110111111111011101010010001
11000000110101011100000000001
1000000000000000000E000111011
10000000101010001001010111011
11000001110101011101111111011
11110111 11101011 100000000011
11111111 1111111 111111111111